w 20 l 8 f 2 c 6 s 1 win 1
 1 1 1 1 1 1 1 1 1 1 1 1 1 1 1 1 1 1 1 1
 1 0 0 0 0 0 0 0 0 1 0 0 0 0 0 0 0 0 9 1
 1 1 1 0 0 0 0 0 0 1 0 0 0 0 0 0 0 0 0 1
 1 P 1 0 0 0 0 0 0 1 0 0 0 0 0 T 0 0 0 1
 1 0 1 0 0 0 0 0 Y 1 0 0 0 0 0 T T 0 0 1
 1 0 0 0 0 0 0 0 Y 1 0 0 0 0 0 0 0 0 0 1
 1 0 0 0 0 0 0 0 0 0 0 0 0 0 0 0 0 0 0 1
 1 1 1 1 1 1 1 1 1 1 1 1 1 1 1 1 1 1 1 1